11111111111111111111111111111111111
10100000100100001000000000000000001
1S100000000101001001000000000000001
10100000100101001001000000000000001
1010000P1001010010C100000000000E001
10100000100101001001000000000000001
10100000100101001001000000000000001
1S100000100101001001000000000000001
10100000100001000001000000000000001
11111111111111111111111111111111111