1111111111111
10000000R0001
10R000E000001
100000000R001
100000R000001
1000000C00001
10000R0000001
1000000P00001
10R0000000R01
1111111111111