11111111111111111111111111
10000000000000000000000001
10000000000000C00000000S01
10000000000000000000000001
10000R000000000000000000E1
10000000000000000000000001
10000000000000000000000001
1000000P0000000000R0000001
10000000000000000000000001
11111111111111111111111111