11111111111111111111111111
1000000000000000Q0000100C1
10000R0000000100000R000001
10000000000000000000010001
100001000000R1000000000001
10000000000000000000010001
10000100000001E00000000001
1000000P000000000000010001
1Q000100000001000000000001
11111111111111111111111111