1111111111111
1000000000001
100000E000001
1000000000001
1000000000001
1000000C00001
1000000000001
1000000P00001
1000000000001
1111111111111