11111111111111111111111111
10000000000000000000000001
100000000000000000Q0000001
10000000000000000000000001
10000000000000000000000001
1000000C000000000000000001
10000000000000E00000000001
1000000P000000000000000001
10000000000000000000000001
11111111111111111111111111