1111111111111111111
1000000000000000011
10000000000000000011
100000000000000000011
1000000000000000000011
1000000C000000000000011
10000000000000E000000011
1000000P00000000000000011
10000000000000000000000011
111111111111111111111111111